#######B##
# ##### ##
#       ##
# ##### ##
#       ##
#A########
